0000000000000000000
0000000000000000001
0000000000000000002
0000000000000000003
0000000000000000004
0000000000000000005
0000000000000000006
0000000000000000007
0000000000000000008
0000000000000000009
0000000000000000010
0000000000000000011
0000000000000000012
0000000000000000013
0000000000000000014
0000000000000000015
0000000000000000016
0000000000000000017
0000000000000000018
0000000000000000019
0000000000000000020
0000000000000000021
0000000000000000022
0000000000000000023
0000000000000000024
0000000000000000025
0000000000000000026
0000000000000000027
0000000000000000028
0000000000000000029
0000000000000000030
0000000000000000031
0000000000000000032
0000000000000000033
0000000000000000034
0000000000000000035
0000000000000000036
0000000000000000037
0000000000000000038
0000000000000000039
0000000000000000040
0000000000000000041
0000000000000000042
0000000000000000043
0000000000000000044
0000000000000000045
0000000000000000046
0000000000000000047
0000000000000000048
0000000000000000049
0000000000000000050
0000000000000000051
0000000000000000052
0000000000000000053
0000000000000000054
0000000000000000055
0000000000000000056
0000000000000000057
0000000000000000058
0000000000000000059
0000000000000000060
0000000000000000061
0000000000000000062
0000000000000000063
0000000000000000064
0000000000000000065
0000000000000000066
0000000000000000067
0000000000000000068
0000000000000000069
0000000000000000070
0000000000000000071
0000000000000000072
0000000000000000073
0000000000000000074
0000000000000000075
0000000000000000076
0000000000000000077
0000000000000000078
0000000000000000079
0000000000000000080
0000000000000000081
0000000000000000082
0000000000000000083
0000000000000000084
0000000000000000085
0000000000000000086
0000000000000000087
0000000000000000088
0000000000000000089
0000000000000000090
0000000000000000091
0000000000000000092
0000000000000000093
0000000000000000094
0000000000000000095
0000000000000000096
0000000000000000097
0000000000000000098
0000000000000000099
